"Unique identification number of the institution","Academic rank","Instructional staff on 9, 10, 11 or 12 month contract-total","Instructional staff on 9, 10, 11 or 12 month contract-men","Instructional staff on 9, 10, 11 or 12 month contract-women","Instructional staff on 9-month contract-total","Instructional staff on 9-month contract-men","Instructional staff on 9-month contract-women","Instructional staff on 10-month contract-total","Instructional staff on 10-month contract-men","Instructional staff on 10-month contract-women","Instructional staff on 11-month contract-total","Instructional staff on 11-month contract-men","Instructional staff on 11-month contract-women","Instructional staff on 12-month contract total","Instructional staff on 12-month contract men","Instructional staff on 12--month contract women","Number months covered for salary outlays - total","Number of months covered for salary outlays - men","Number of months covered for salary outlays - women","Salary outlays - total","Salary outlays - men","Salary outlays - women","Average weighted monthly salary  - total","Average weighted monthly salary  - men","Average weighted monthly salary  - women","FY","Fall","Institution_Name","Survey Code","Survey Title","ARANK_desc"
"131496","1"," 309"," 218"," 91"," 304","217"," 87","  0"," 0"," 0","0","0","0","  5","  1","  4"," 2796"," 1965"," 831"," 53852316"," 38661531","15190785","19260","19675","18280","2013","2012","Georgetown University","sal_ic","Instructional Staff Salary","Professor"
"131496","2"," 228"," 131"," 97"," 223","129"," 94","  0"," 0"," 0","0","0","0","  5","  2","  3"," 2067"," 1185"," 882"," 25067858"," 14668256","10399602","12128","12378","11791","2013","2012","Georgetown University","sal_ic","Instructional Staff Salary","Associate professor"
"131496","3"," 121","  61"," 60"," 113"," 58"," 55","  0"," 0"," 0","0","0","0","  8","  3","  5"," 1113","  558"," 555"," 11719895","  6314061"," 5405834","10530","11316"," 9740","2013","2012","Georgetown University","sal_ic","Instructional Staff Salary","Assistant professor"
"131496","6"," 331"," 143","188"," 241","116","125","  0"," 0"," 0","0","0","0"," 90"," 27"," 63"," 3249"," 1368","1881"," 28079064"," 12801327","15277737"," 8642"," 9358"," 8122","2013","2012","Georgetown University","sal_ic","Instructional Staff Salary","No academic rank"
"131496","7"," 989"," 553","436"," 881","520","361","  0"," 0"," 0","0","0","0","108"," 33"," 75"," 9225"," 5076","4149","118719133"," 72445175","46273958","12869","14272","11153","2013","2012","Georgetown University","sal_ic","Instructional Staff Salary","All instructional staff total"
"147767","1"," 568"," 435","133"," 568","435","133","  0"," 0"," 0","0","0","0","  0","  0","  0"," 5112"," 3915","1197","100271511"," 79182318","21089193","19615","20225","17618","2013","2012","Northwestern University","sal_ic","Instructional Staff Salary","Professor"
"147767","2"," 278"," 180"," 98"," 278","180"," 98","  0"," 0"," 0","0","0","0","  0","  0","  0"," 2502"," 1620"," 882"," 31306032"," 20831275","10474757","12512","12859","11876","2013","2012","Northwestern University","sal_ic","Instructional Staff Salary","Associate professor"
"147767","3"," 265"," 161","104"," 265","161","104","  0"," 0"," 0","0","0","0","  0","  0","  0"," 2385"," 1449"," 936"," 26075580"," 16493626"," 9581954","10933","11383","10237","2013","2012","Northwestern University","sal_ic","Instructional Staff Salary","Assistant professor"
"147767","5"," 278"," 118","160"," 278","118","160","  0"," 0"," 0","0","0","0","  0","  0","  0"," 2502"," 1062","1440"," 17654097","  8274739"," 9379358"," 7056"," 7792"," 6513","2013","2012","Northwestern University","sal_ic","Instructional Staff Salary","Lecturer"
"147767","7","1389"," 894","495","1389","894","495","  0"," 0"," 0","0","0","0","  0","  0","  0","12501"," 8046","4455","175307220","124781958","50525262","14023","15509","11341","2013","2012","Northwestern University","sal_ic","Instructional Staff Salary","All instructional staff total"
"162928","1"," 351"," 277"," 74"," 262","209"," 53"," 14","13"," 1","0","0","0"," 75"," 55"," 20"," 3398"," 2671"," 727"," 58349217"," 46749703","11599514","17172","17503","15955","2013","2012","Johns Hopkins University","sal_ic","Instructional Staff Salary","Professor"
"162928","2"," 123","  79"," 44","  80"," 58"," 22","  1"," 1"," 0","0","0","0"," 42"," 20"," 22"," 1234","  772"," 462"," 14427361","  9388772"," 5038589","11692","12162","10906","2013","2012","Johns Hopkins University","sal_ic","Instructional Staff Salary","Associate professor"
"162928","3"," 183"," 100"," 83"," 102"," 67"," 35","  0"," 0"," 0","0","0","0"," 81"," 33"," 48"," 1890","  999"," 891"," 18209422"," 10042421"," 8167001"," 9635","10052"," 9166","2013","2012","Johns Hopkins University","sal_ic","Instructional Staff Salary","Assistant professor"
"162928","4","  44","   9"," 35","   5","  2","  3","  0"," 0"," 0","0","0","0"," 39","  7"," 32","  513","  102"," 411","  3223889","   678313"," 2545576"," 6284"," 6650"," 6194","2013","2012","Johns Hopkins University","sal_ic","Instructional Staff Salary","Instructor"
"162928","5"," 162","  67"," 95"," 107"," 41"," 66","  1"," 1"," 0","1","0","1"," 53"," 25"," 28"," 1620","  679"," 941"," 10682539","  4796684"," 5885855"," 6594"," 7064"," 6255","2013","2012","Johns Hopkins University","sal_ic","Instructional Staff Salary","Lecturer"
"162928","6"," 292"," 169","123","  29"," 23","  6","100","59","41","0","0","0","163"," 87"," 76"," 3217"," 1841","1376"," 24178234"," 15226285"," 8951949"," 7516"," 8271"," 6506","2013","2012","Johns Hopkins University","sal_ic","Instructional Staff Salary","No academic rank"
"162928","7","1155"," 701","454"," 585","400","185","116","74","42","1","0","1","453","227","226","11872"," 7064","4808","129070662"," 86882178","42188484","10872","12299"," 8775","2013","2012","Johns Hopkins University","sal_ic","Instructional Staff Salary","All instructional staff total"
"164924","1"," 259"," 182"," 77"," 259","182"," 77","  0"," 0"," 0","0","0","0","  0","  0","  0"," 2331"," 1638"," 693"," 41230906"," 30218141","11012765","17688","18448","15891","2013","2012","Boston College","sal_ic","Instructional Staff Salary","Professor"
"164924","2"," 265"," 155","110"," 265","155","110","  0"," 0"," 0","0","0","0","  0","  0","  0"," 2385"," 1395"," 990"," 27390997"," 16230928","11160069","11485","11635","11273","2013","2012","Boston College","sal_ic","Instructional Staff Salary","Associate professor"
"164924","3"," 194"," 102"," 92"," 194","102"," 92","  0"," 0"," 0","0","0","0","  0","  0","  0"," 1746","  918"," 828"," 17126349","  9527169"," 7599180"," 9809","10378"," 9178","2013","2012","Boston College","sal_ic","Instructional Staff Salary","Assistant professor"
"164924","4","  10","   3","  7","  10","  3","  7","  0"," 0"," 0","0","0","0","  0","  0","  0","   90","   27","  63","   731799","   280973","  450826"," 8131","10406"," 7156","2013","2012","Boston College","sal_ic","Instructional Staff Salary","Instructor"
"164924","5","  33","  18"," 15","  33"," 18"," 15","  0"," 0"," 0","0","0","0","  0","  0","  0","  297","  162"," 135","  2774870","  1652817"," 1122053"," 9343","10203"," 8312","2013","2012","Boston College","sal_ic","Instructional Staff Salary","Lecturer"
"164924","7"," 761"," 460","301"," 761","460","301","  0"," 0"," 0","0","0","0","  0","  0","  0"," 6849"," 4140","2709"," 89254921"," 57910028","31344893","13032","13988","11571","2013","2012","Boston College","sal_ic","Instructional Staff Salary","All instructional staff total"
"168148","1"," 247"," 187"," 60"," 194","146"," 48","  0"," 0"," 0","0","0","0"," 53"," 41"," 12"," 2382"," 1806"," 576"," 35161466"," 27054350"," 8107116","14761","14980","14075","2013","2012","Tufts University","sal_ic","Instructional Staff Salary","Professor"
"168148","2"," 175"," 101"," 74"," 121"," 71"," 50","  0"," 0"," 0","0","0","0"," 54"," 30"," 24"," 1737","  999"," 738"," 18521815"," 10847043"," 7674772","10663","10858","10399","2013","2012","Tufts University","sal_ic","Instructional Staff Salary","Associate professor"
"168148","3"," 180"," 100"," 80","  89"," 51"," 38","  0"," 0"," 0","0","0","0"," 91"," 49"," 42"," 1893"," 1047"," 846"," 16008532","  8934096"," 7074436"," 8457"," 8533"," 8362","2013","2012","Tufts University","sal_ic","Instructional Staff Salary","Assistant professor"
"168148","4","  22","  13","  9","   0","  0","  0","  0"," 0"," 0","0","0","0"," 22"," 13","  9","  264","  156"," 108","  1897750","  1097752","  799998"," 7188"," 7037"," 7407","2013","2012","Tufts University","sal_ic","Instructional Staff Salary","Instructor"
"168148","5","  98","  40"," 58","  98"," 40"," 58","  0"," 0"," 0","0","0","0","  0","  0","  0","  882","  360"," 522","  6335132","  2645131"," 3690001"," 7183"," 7348"," 7069","2013","2012","Tufts University","sal_ic","Instructional Staff Salary","Lecturer"
"168148","7"," 722"," 441","281"," 502","308","194","  0"," 0"," 0","0","0","0","220","133"," 87"," 7158"," 4368","2790"," 77924695"," 50578372","27346323","10886","11579"," 9802","2013","2012","Tufts University","sal_ic","Instructional Staff Salary","All instructional staff total"
"179867","1"," 351"," 264"," 87"," 337","255"," 82","  3"," 0"," 3","1","1","0"," 10","  8","  2"," 3194"," 2402"," 792"," 59636840"," 46008849","13627991","18672","19154","17207","2013","2012","Washington University in St Louis","sal_ic","Instructional Staff Salary","Professor"
"179867","2"," 163","  98"," 65"," 161"," 97"," 64","  0"," 0"," 0","0","0","0","  2","  1","  1"," 1473","  885"," 588"," 16902458"," 10563369"," 6339089","11475","11936","10781","2013","2012","Washington University in St Louis","sal_ic","Instructional Staff Salary","Associate professor"
"179867","3"," 170"," 107"," 63"," 165","105"," 60","  0"," 0"," 0","0","0","0","  5","  2","  3"," 1545","  969"," 576"," 16417919"," 10622148"," 5795771","10626","10962","10062","2013","2012","Washington University in St Louis","sal_ic","Instructional Staff Salary","Assistant professor"
"179867","5"," 156","  69"," 87"," 121"," 49"," 72","  7"," 3"," 4","2","0","2"," 26"," 17","  9"," 1493","  675"," 818","  9316887","  4642971"," 4673916"," 6240"," 6878"," 5714","2013","2012","Washington University in St Louis","sal_ic","Instructional Staff Salary","Lecturer"
"179867","6","  22","   8"," 14","  13","  3"," 10","  0"," 0"," 0","0","0","0","  9","  5","  4","  225","   87"," 138","  1313511","   511259","  802252"," 5838"," 5877"," 5813","2013","2012","Washington University in St Louis","sal_ic","Instructional Staff Salary","No academic rank"
"179867","7"," 862"," 546","316"," 797","509","288"," 10"," 3"," 7","3","1","2"," 52"," 33"," 19"," 7930"," 5018","2912","103587615"," 72348596","31239019","13063","14418","10728","2013","2012","Washington University in St Louis","sal_ic","Instructional Staff Salary","All instructional staff total"
"182670","1"," 223"," 162"," 61"," 202","145"," 57","  1"," 1"," 0","0","0","0"," 20"," 16","  4"," 2068"," 1507"," 561"," 37120116"," 28321041"," 8799075","17950","18793","15685","2013","2012","Dartmouth College","sal_ic","Instructional Staff Salary","Professor"
"182670","2"," 143","  88"," 55"," 124"," 74"," 50","  0"," 0"," 0","0","0","0"," 19"," 14","  5"," 1344","  834"," 510"," 15858849"," 10113768"," 5745081","11800","12127","11265","2013","2012","Dartmouth College","sal_ic","Instructional Staff Salary","Associate professor"
"182670","3"," 112","  64"," 48","  49"," 26"," 23","  3"," 3"," 0","0","0","0"," 60"," 35"," 25"," 1191","  684"," 507","  9980251","  5763632"," 4216619"," 8380"," 8426"," 8317","2013","2012","Dartmouth College","sal_ic","Instructional Staff Salary","Assistant professor"
"182670","4","   2","   1","  1","   0","  0","  0","  0"," 0"," 0","0","0","0","  2","  1","  1","   24","   12","  12","   133000","    66500","   66500"," 5542"," 5542"," 5542","2013","2012","Dartmouth College","sal_ic","Instructional Staff Salary","Instructor"
"182670","5","  45","  18"," 27","   0","  0","  0","  5"," 2"," 3","0","0","0"," 40"," 16"," 24","  530","  212"," 318","  3023164","  1199931"," 1823233"," 5704"," 5660"," 5733","2013","2012","Dartmouth College","sal_ic","Instructional Staff Salary","Lecturer"
"182670","6","   4","   2","  2","   0","  0","  0","  3"," 1"," 2","0","0","0","  1","  1","  0","   42","   22","  20","   243400","   225000","   18400"," 5795","10227","  920","2013","2012","Dartmouth College","sal_ic","Instructional Staff Salary","No academic rank"
"182670","7"," 529"," 335","194"," 375","245","130"," 12"," 7"," 5","0","0","0","142"," 83"," 59"," 5199"," 3271","1928"," 66358780"," 45689872","20668908","12764","13968","10720","2013","2012","Dartmouth College","sal_ic","Instructional Staff Salary","All instructional staff total"
"190150","1"," 719"," 551","168"," 719","551","168","  0"," 0"," 0","0","0","0","  0","  0","  0"," 6471"," 4959","1512","143591521","112571250","31020271","22190","22700","20516","2013","2012","Columbia University in the City of New York","sal_ic","Instructional Staff Salary","Professor"
"190150","2"," 242"," 155"," 87"," 242","155"," 87","  0"," 0"," 0","0","0","0","  0","  0","  0"," 2178"," 1395"," 783"," 30450214"," 20617668"," 9832546","13981","14780","12558","2013","2012","Columbia University in the City of New York","sal_ic","Instructional Staff Salary","Associate professor"
"190150","3"," 211"," 136"," 75"," 211","136"," 75","  0"," 0"," 0","0","0","0","  0","  0","  0"," 1899"," 1224"," 675"," 21215121"," 14128688"," 7086433","11172","11543","10498","2013","2012","Columbia University in the City of New York","sal_ic","Instructional Staff Salary","Assistant professor"
"190150","4","   5","   5","  0","   5","  5","  0","  0"," 0"," 0","0","0","0","  0","  0","  0","   45","   45","   0","   524650","   524650","       0","11659","11659",,"2013","2012","Columbia University in the City of New York","sal_ic","Instructional Staff Salary","Instructor"
"190150","5"," 268"," 117","151"," 268","117","151","  0"," 0"," 0","0","0","0","  0","  0","  0"," 2412"," 1053","1359"," 20612975"," 10791729"," 9821246"," 8546","10249"," 7227","2013","2012","Columbia University in the City of New York","sal_ic","Instructional Staff Salary","Lecturer"
"190150","7","1445"," 964","481","1445","964","481","  0"," 0"," 0","0","0","0","  0","  0","  0","13005"," 8676","4329","216394481","158633985","57760496","16639","18284","13343","2013","2012","Columbia University in the City of New York","sal_ic","Instructional Staff Salary","All instructional staff total"
"190415","1"," 770"," 600","170"," 642","497","145","  0"," 0"," 0","0","0","0","128","103"," 25"," 7314"," 5709","1605","126882361","100002359","26880002","17348","17517","16748","2013","2012","Cornell University","sal_ic","Instructional Staff Salary","Professor"
"190415","2"," 430"," 283","147"," 348","226","122","  0"," 0"," 0","0","0","0"," 82"," 57"," 25"," 4116"," 2718","1398"," 49275775"," 33012278","16263497","11972","12146","11633","2013","2012","Cornell University","sal_ic","Instructional Staff Salary","Associate professor"
"190415","3"," 285"," 170","115"," 263","157","106","  0"," 0"," 0","0","0","0"," 22"," 13","  9"," 2631"," 1569","1062"," 27390646"," 16705884","10684762","10411","10647","10061","2013","2012","Cornell University","sal_ic","Instructional Staff Salary","Assistant professor"
"190415","4","   5","   2","  3","   1","  1","  0","  0"," 0"," 0","0","0","0","  4","  1","  3","   57","   21","  36","   430374","   200374","  230000"," 7550"," 9542"," 6389","2013","2012","Cornell University","sal_ic","Instructional Staff Salary","Instructor"
"190415","5"," 238"," 110","128"," 188"," 87","101","  0"," 0"," 0","0","0","0"," 50"," 23"," 27"," 2292"," 1059","1233"," 18093347","  8599706"," 9493641"," 7894"," 8121"," 7700","2013","2012","Cornell University","sal_ic","Instructional Staff Salary","Lecturer"
"190415","7","1728","1165","563","1442","968","474","  0"," 0"," 0","0","0","0","286","197"," 89","16410","11076","5334","222072503","158520601","63551902","13533","14312","11914","2013","2012","Cornell University","sal_ic","Instructional Staff Salary","All instructional staff total"
"198419","1"," 617"," 467","150"," 617","467","150","  0"," 0"," 0","0","0","0","  0","  0","  0"," 5553"," 4203","1350","107503976"," 82992573","24511403","19360","19746","18157","2013","2012","Duke University","sal_ic","Instructional Staff Salary","Professor"
"198419","2"," 283"," 169","114"," 283","169","114","  0"," 0"," 0","0","0","0","  0","  0","  0"," 2547"," 1521","1026"," 31625431"," 20333663","11291768","12417","13369","11006","2013","2012","Duke University","sal_ic","Instructional Staff Salary","Associate professor"
"198419","3"," 239"," 132","107"," 239","132","107","  0"," 0"," 0","0","0","0","  0","  0","  0"," 2151"," 1188"," 963"," 20720183"," 11869309"," 8850874"," 9633"," 9991"," 9191","2013","2012","Duke University","sal_ic","Instructional Staff Salary","Assistant professor"
"198419","4"," 335"," 167","168"," 335","167","168","  0"," 0"," 0","0","0","0","  0","  0","  0"," 3015"," 1503","1512"," 18052692","  9974634"," 8078058"," 5988"," 6636"," 5343","2013","2012","Duke University","sal_ic","Instructional Staff Salary","Instructor"
"198419","5","  37","  11"," 26","  37"," 11"," 26","  0"," 0"," 0","0","0","0","  0","  0","  0","  333","   99"," 234","  2167250","   708950"," 1458300"," 6508"," 7161"," 6232","2013","2012","Duke University","sal_ic","Instructional Staff Salary","Lecturer"
"198419","7","1511"," 946","565","1511","946","565","  0"," 0"," 0","0","0","0","  0","  0","  0","13599"," 8514","5085","180069532","125879129","54190403","13241","14785","10657","2013","2012","Duke University","sal_ic","Instructional Staff Salary","All instructional staff total"
"215062","1"," 574"," 442","132"," 574","442","132","  0"," 0"," 0","0","0","0","  0","  0","  0"," 5166"," 3978","1188","107322472"," 84264730","23057742","20775","21183","19409","2013","2012","University of Pennsylvania","sal_ic","Instructional Staff Salary","Professor"
"215062","2"," 242"," 153"," 89"," 242","153"," 89","  0"," 0"," 0","0","0","0","  0","  0","  0"," 2178"," 1377"," 801"," 28386500"," 18974447"," 9412053","13033","13780","11750","2013","2012","University of Pennsylvania","sal_ic","Instructional Staff Salary","Associate professor"
"215062","3"," 230"," 139"," 91"," 230","139"," 91","  0"," 0"," 0","0","0","0","  0","  0","  0"," 2070"," 1251"," 819"," 26736517"," 17086439"," 9650078","12916","13658","11783","2013","2012","University of Pennsylvania","sal_ic","Instructional Staff Salary","Assistant professor"
"215062","5"," 278","  96","182"," 278"," 96","182","  0"," 0"," 0","0","0","0","  0","  0","  0"," 2502","  864","1638"," 17456958","  6443483","11013475"," 6977"," 7458"," 6724","2013","2012","University of Pennsylvania","sal_ic","Instructional Staff Salary","Lecturer"
"215062","7","1324"," 830","494","1324","830","494","  0"," 0"," 0","0","0","0","  0","  0","  0","11916"," 7470","4446","179902447","126769099","53133348","15098","16970","11951","2013","2012","University of Pennsylvania","sal_ic","Instructional Staff Salary","All instructional staff total"
"217156","1"," 370"," 278"," 92"," 305","235"," 70"," 58","40","18","0","0","0","  7","  3","  4"," 3409"," 2551"," 858"," 58961127"," 45029338","13931789","17296","17652","16238","2013","2012","Brown University","sal_ic","Instructional Staff Salary","Professor"
"217156","2"," 129","  82"," 47"," 105"," 63"," 42"," 20","15"," 5","0","0","0","  4","  4","  0"," 1193","  765"," 428"," 13198909","  8476711"," 4722198","11064","11081","11033","2013","2012","Brown University","sal_ic","Instructional Staff Salary","Associate professor"
"217156","3"," 134","  84"," 50"," 102"," 62"," 40"," 32","22","10","0","0","0","  0","  0","  0"," 1238","  778"," 460"," 11512145","  7491422"," 4020723"," 9299"," 9629"," 8741","2013","2012","Brown University","sal_ic","Instructional Staff Salary","Assistant professor"
"217156","5","  65","  21"," 44","  60"," 19"," 41","  5"," 2"," 3","0","0","0","  0","  0","  0","  590","  191"," 399","  4864827","  1511073"," 3353754"," 8245"," 7911"," 8405","2013","2012","Brown University","sal_ic","Instructional Staff Salary","Lecturer"
"217156","6","  72","  28"," 44","  11","  5","  6"," 13"," 7"," 6","6","1","5"," 42"," 15"," 27","  799","  306"," 493","  3417340","  1459195"," 1958145"," 4277"," 4769"," 3972","2013","2012","Brown University","sal_ic","Instructional Staff Salary","No academic rank"
"217156","7"," 770"," 493","277"," 583","384","199","128","86","42","6","1","5"," 53"," 22"," 31"," 7229"," 4591","2638"," 91954348"," 63967739","27986609","12720","13933","10609","2013","2012","Brown University","sal_ic","Instructional Staff Salary","All instructional staff total"
"131496","1"," 307"," 214"," 93"," 302"," 213"," 89","  0"," 0"," 0","0","0","0","  5","  1","  4"," 2778"," 1929"," 849"," 52970606"," 37620262","15350344","19068","19502","18080","2014","2013","Georgetown University","sal_ic","Instructional Staff Salary","Professor"
"131496","2"," 231"," 128","103"," 227"," 127","100","  0"," 0"," 0","0","0","0","  4","  1","  3"," 2091"," 1155"," 936"," 24837562"," 14170386","10667176","11878","12269","11397","2014","2013","Georgetown University","sal_ic","Instructional Staff Salary","Associate professor"
"131496","3"," 109","  52"," 57"," 101","  48"," 53","  0"," 0"," 0","0","0","0","  8","  4","  4"," 1005","  480"," 525"," 10859658","  5390239"," 5469419","10806","11230","10418","2014","2013","Georgetown University","sal_ic","Instructional Staff Salary","Assistant professor"
"131496","6"," 327"," 144","183"," 250"," 124","126","  0"," 0"," 0","0","0","0"," 77"," 20"," 57"," 3174"," 1356","1818"," 27606990"," 12701761","14905229"," 8698"," 9367"," 8199","2014","2013","Georgetown University","sal_ic","Instructional Staff Salary","No academic rank"
"131496","7"," 974"," 538","436"," 880"," 512","368","  0"," 0"," 0","0","0","0"," 94"," 26"," 68"," 9048"," 4920","4128","116274816"," 69882648","46392168","12851","14204","11238","2014","2013","Georgetown University","sal_ic","Instructional Staff Salary","All instructional staff total"
"147767","1"," 589"," 445","144"," 589"," 445","144","  0"," 0"," 0","0","0","0","  0","  0","  0"," 5301"," 4005","1296","107172096"," 83564154","23607942","20217","20865","18216","2014","2013","Northwestern University","sal_ic","Instructional Staff Salary","Professor"
"147767","2"," 281"," 182"," 99"," 281"," 182"," 99","  0"," 0"," 0","0","0","0","  0","  0","  0"," 2529"," 1638"," 891"," 32260340"," 21530766","10729574","12756","13145","12042","2014","2013","Northwestern University","sal_ic","Instructional Staff Salary","Associate professor"
"147767","3"," 252"," 152","100"," 252"," 152","100","  0"," 0"," 0","0","0","0","  0","  0","  0"," 2268"," 1368"," 900"," 25890286"," 16314532"," 9575754","11415","11926","10640","2014","2013","Northwestern University","sal_ic","Instructional Staff Salary","Assistant professor"
"147767","5"," 287"," 118","169"," 287"," 118","169","  0"," 0"," 0","0","0","0","  0","  0","  0"," 2583"," 1062","1521"," 18871688","  8520318","10351370"," 7306"," 8023"," 6806","2014","2013","Northwestern University","sal_ic","Instructional Staff Salary","Lecturer"
"147767","7","1409"," 897","512","1409"," 897","512","  0"," 0"," 0","0","0","0","  0","  0","  0","12681"," 8073","4608","184194410","129929770","54264640","14525","16094","11776","2014","2013","Northwestern University","sal_ic","Instructional Staff Salary","All instructional staff total"
"162928","1"," 350"," 275"," 75"," 260"," 207"," 53"," 17","16"," 1","0","0","0"," 73"," 52"," 21"," 3386"," 2647"," 739"," 59518415"," 47451557","12066858","17578","17927","16329","2014","2013","Johns Hopkins University","sal_ic","Instructional Staff Salary","Professor"
"162928","2"," 121","  72"," 49","  74","  52"," 22","  0"," 0"," 0","0","0","0"," 47"," 20"," 27"," 1230","  708"," 522"," 14616931","  8705210"," 5911721","11884","12295","11325","2014","2013","Johns Hopkins University","sal_ic","Instructional Staff Salary","Associate professor"
"162928","3"," 219"," 116","103"," 132","  83"," 49","  0"," 0"," 0","0","0","0"," 87"," 33"," 54"," 2232"," 1143","1089"," 22034161"," 11882446","10151715"," 9872","10396"," 9322","2014","2013","Johns Hopkins University","sal_ic","Instructional Staff Salary","Assistant professor"
"162928","4","  29","   3"," 26","   0","   0","  0","  0"," 0"," 0","0","0","0"," 29","  3"," 26","  348","   36"," 312","  2190912","   251894"," 1939018"," 6296"," 6997"," 6215","2014","2013","Johns Hopkins University","sal_ic","Instructional Staff Salary","Instructor"
"162928","5"," 174","  69","105"," 101","  34"," 67","  1"," 1"," 0","0","0","0"," 72"," 34"," 38"," 1783","  724","1059"," 11742606","  5011414"," 6731192"," 6586"," 6922"," 6356","2014","2013","Johns Hopkins University","sal_ic","Instructional Staff Salary","Lecturer"
"162928","6"," 327"," 184","143","  25","  14"," 11"," 97","58","39","0","0","0","205","112"," 93"," 3655"," 2050","1605"," 27885279"," 16980224","10905055"," 7629"," 8283"," 6794","2014","2013","Johns Hopkins University","sal_ic","Instructional Staff Salary","No academic rank"
"162928","7","1220"," 719","501"," 592"," 390","202","115","75","40","0","0","0","513","254","259","12634"," 7308","5326","137988304"," 90282745","47705559","10922","12354"," 8957","2014","2013","Johns Hopkins University","sal_ic","Instructional Staff Salary","All instructional staff total"
"164924","1"," 244"," 172"," 72"," 244"," 172"," 72","  0"," 0"," 0","0","0","0","  0","  0","  0"," 2196"," 1548"," 648"," 41101345"," 29932370","11168975","18716","19336","17236","2014","2013","Boston College","sal_ic","Instructional Staff Salary","Professor"
"164924","2"," 257"," 143","114"," 257"," 143","114","  0"," 0"," 0","0","0","0","  0","  0","  0"," 2313"," 1287","1026"," 27220345"," 15240416","11979929","11768","11842","11676","2014","2013","Boston College","sal_ic","Instructional Staff Salary","Associate professor"
"164924","3"," 217"," 118"," 99"," 217"," 118"," 99","  0"," 0"," 0","0","0","0","  0","  0","  0"," 1953"," 1062"," 891"," 19445962"," 10953933"," 8492029"," 9957","10314"," 9531","2014","2013","Boston College","sal_ic","Instructional Staff Salary","Assistant professor"
"164924","4","   8","   1","  7","   8","   1","  7","  0"," 0"," 0","0","0","0","  0","  0","  0","   72","    9","  63","   516703","    59132","  457571"," 7176"," 6570"," 7263","2014","2013","Boston College","sal_ic","Instructional Staff Salary","Instructor"
"164924","5","  32","  19"," 13","  32","  19"," 13","  0"," 0"," 0","0","0","0","  0","  0","  0","  288","  171"," 117","  2822962","  1843373","  979589"," 9802","10780"," 8373","2014","2013","Boston College","sal_ic","Instructional Staff Salary","Lecturer"
"164924","7"," 758"," 453","305"," 758"," 453","305","  0"," 0"," 0","0","0","0","  0","  0","  0"," 6822"," 4077","2745"," 91107317"," 58029224","33078093","13355","14233","12050","2014","2013","Boston College","sal_ic","Instructional Staff Salary","All instructional staff total"
"168148","1"," 251"," 185"," 66"," 197"," 146"," 51","  0"," 0"," 0","0","0","0"," 54"," 39"," 15"," 2421"," 1782"," 639"," 36835474"," 27484913"," 9350561","15215","15424","14633","2014","2013","Tufts University","sal_ic","Instructional Staff Salary","Professor"
"168148","2"," 170","  94"," 76"," 126","  71"," 55","  0"," 0"," 0","0","0","0"," 44"," 23"," 21"," 1662","  915"," 747"," 18306213"," 10279764"," 8026449","11015","11235","10745","2014","2013","Tufts University","sal_ic","Instructional Staff Salary","Associate professor"
"168148","3"," 166","  91"," 75","  88","  53"," 35","  0"," 0"," 0","0","0","0"," 78"," 38"," 40"," 1728","  933"," 795"," 15499976","  8422376"," 7077600"," 8970"," 9027"," 8903","2014","2013","Tufts University","sal_ic","Instructional Staff Salary","Assistant professor"
"168148","4","   7","   5","  2","   0","   0","  0","  0"," 0"," 0","0","0","0","  7","  5","  2","   84","   60","  24","   625606","   447564","  178042"," 7448"," 7459"," 7418","2014","2013","Tufts University","sal_ic","Instructional Staff Salary","Instructor"
"168148","5"," 102","  43"," 59"," 102","  43"," 59","  0"," 0"," 0","0","0","0","  0","  0","  0","  918","  387"," 531","  6584545","  2872729"," 3711816"," 7173"," 7423"," 6990","2014","2013","Tufts University","sal_ic","Instructional Staff Salary","Lecturer"
"168148","7"," 696"," 418","278"," 513"," 313","200","  0"," 0"," 0","0","0","0","183","105"," 78"," 6813"," 4077","2736"," 77851814"," 49507346","28344468","11427","12143","10360","2014","2013","Tufts University","sal_ic","Instructional Staff Salary","All instructional staff total"
"179867","1"," 346"," 262"," 84"," 327"," 248"," 79","  2"," 0"," 2","1","1","0"," 16"," 13","  3"," 3166"," 2399"," 767"," 60946333"," 47470191","13476142","19250","19787","17570","2014","2013","Washington University in St Louis","sal_ic","Instructional Staff Salary","Professor"
"179867","2"," 183"," 107"," 76"," 180"," 105"," 75","  0"," 0"," 0","1","1","0","  2","  1","  1"," 1655","  968"," 687"," 20120320"," 12062988"," 8057332","12157","12462","11728","2014","2013","Washington University in St Louis","sal_ic","Instructional Staff Salary","Associate professor"
"179867","3"," 170"," 105"," 65"," 168"," 104"," 64","  0"," 0"," 0","0","0","0","  2","  1","  1"," 1536","  948"," 588"," 16433842"," 10398334"," 6035508","10699","10969","10264","2014","2013","Washington University in St Louis","sal_ic","Instructional Staff Salary","Assistant professor"
"179867","4","   1","   1","  0","   1","   1","  0","  0"," 0"," 0","0","0","0","  0","  0","  0","    9","    9","   0","    27500","    27500","       0"," 3056"," 3056",,"2014","2013","Washington University in St Louis","sal_ic","Instructional Staff Salary","Instructor"
"179867","5"," 170","  75"," 95"," 134","  54"," 80","  7"," 2"," 5","2","0","2"," 27"," 19","  8"," 1622","  734"," 888"," 10173746","  5096834"," 5076912"," 6272"," 6944"," 5717","2014","2013","Washington University in St Louis","sal_ic","Instructional Staff Salary","Lecturer"
"179867","6","  22","   7"," 15","  12","   3","  9","  1"," 0"," 1","0","0","0","  9","  4","  5","  226","   75"," 151","  1432743","   466262","  966481"," 6340"," 6217"," 6401","2014","2013","Washington University in St Louis","sal_ic","Instructional Staff Salary","No academic rank"
"179867","7"," 892"," 557","335"," 822"," 515","307"," 10"," 2"," 8","4","2","2"," 56"," 38"," 18"," 8214"," 5133","3081","109134484"," 75522109","33612375","13286","14713","10910","2014","2013","Washington University in St Louis","sal_ic","Instructional Staff Salary","All instructional staff total"
"182670","1"," 230"," 166"," 64"," 204"," 144"," 60","  0"," 0"," 0","0","0","0"," 26"," 22","  4"," 2148"," 1560"," 588"," 40038253"," 30406528"," 9631725","18640","19491","16380","2014","2013","Dartmouth College","sal_ic","Instructional Staff Salary","Professor"
"182670","2"," 145","  87"," 58"," 120","  71"," 49","  0"," 0"," 0","0","0","0"," 25"," 16","  9"," 1380","  831"," 549"," 16394059"," 10024129"," 6369930","11880","12063","11603","2014","2013","Dartmouth College","sal_ic","Instructional Staff Salary","Associate professor"
"182670","3"," 114","  67"," 47","  39","  22"," 17","  1"," 1"," 0","0","0","0"," 74"," 44"," 30"," 1249","  736"," 513"," 10774814","  6452268"," 4322546"," 8627"," 8767"," 8426","2014","2013","Dartmouth College","sal_ic","Instructional Staff Salary","Assistant professor"
"182670","4","   5","   3","  2","   0","   0","  0","  4"," 2"," 2","0","0","0","  1","  1","  0","   52","   32","  20","    72000","    48000","   24000"," 1385"," 1500"," 1200","2014","2013","Dartmouth College","sal_ic","Instructional Staff Salary","Instructor"
"182670","5","  41","  14"," 27","   0","   0","  0","  2"," 1"," 1","0","0","0"," 39"," 13"," 26","  488","  166"," 322","  2968072","  1049121"," 1918951"," 6082"," 6320"," 5959","2014","2013","Dartmouth College","sal_ic","Instructional Staff Salary","Lecturer"
"182670","6","   3","   1","  2","   0","   0","  0","  3"," 1"," 2","0","0","0","  0","  0","  0","   30","   10","  20","    28660","     9200","   19460","  955","  920","  973","2014","2013","Dartmouth College","sal_ic","Instructional Staff Salary","No academic rank"
"182670","7"," 538"," 338","200"," 363"," 237","126"," 10"," 5"," 5","0","0","0","165"," 96"," 69"," 5347"," 3335","2012"," 70275858"," 47989246","22286612","13143","14390","11077","2014","2013","Dartmouth College","sal_ic","Instructional Staff Salary","All instructional staff total"
"190150","1"," 752"," 575","177"," 752"," 575","177","  0"," 0"," 0","0","0","0","  0","  0","  0"," 6768"," 5175","1593","145733693","113492489","32241204","21533","21931","20239","2014","2013","Columbia University in the City of New York","sal_ic","Instructional Staff Salary","Professor"
"190150","2"," 239"," 155"," 84"," 239"," 155"," 84","  0"," 0"," 0","0","0","0","  0","  0","  0"," 2151"," 1395"," 756"," 31485715"," 21325543","10160172","14638","15287","13439","2014","2013","Columbia University in the City of New York","sal_ic","Instructional Staff Salary","Associate professor"
"190150","3"," 210"," 138"," 72"," 210"," 138"," 72","  0"," 0"," 0","0","0","0","  0","  0","  0"," 1890"," 1242"," 648"," 21389835"," 14485764"," 6904071","11317","11663","10654","2014","2013","Columbia University in the City of New York","sal_ic","Instructional Staff Salary","Assistant professor"
"190150","4","   2","   2","  0","   2","   2","  0","  0"," 0"," 0","0","0","0","  0","  0","  0","   18","   18","   0","   361444","   361444","       0","20080","20080",,"2014","2013","Columbia University in the City of New York","sal_ic","Instructional Staff Salary","Instructor"
"190150","5"," 352"," 175","177"," 352"," 175","177","  0"," 0"," 0","0","0","0","  0","  0","  0"," 3168"," 1575","1593"," 20833447"," 10618369","10215078"," 6576"," 6742"," 6412","2014","2013","Columbia University in the City of New York","sal_ic","Instructional Staff Salary","Lecturer"
"190150","7","1555","1045","510","1555","1045","510","  0"," 0"," 0","0","0","0","  0","  0","  0","13995"," 9405","4590","219804134","160283609","59520525","15706","17042","12967","2014","2013","Columbia University in the City of New York","sal_ic","Instructional Staff Salary","All instructional staff total"
"190415","1"," 752"," 587","165"," 636"," 492","144","  0"," 0"," 0","0","0","0","116"," 95"," 21"," 7116"," 5568","1548","126854711","100424925","26429786","17827","18036","17074","2014","2013","Cornell University","sal_ic","Instructional Staff Salary","Professor"
"190415","2"," 431"," 271","160"," 354"," 220","134","  0"," 0"," 0","0","0","0"," 77"," 51"," 26"," 4110"," 2592","1518"," 51180346"," 32728924","18451422","12453","12627","12155","2014","2013","Cornell University","sal_ic","Instructional Staff Salary","Associate professor"
"190415","3"," 289"," 179","110"," 255"," 160"," 95","  0"," 0"," 0","0","0","0"," 34"," 19"," 15"," 2703"," 1668","1035"," 28506510"," 17953268","10553242","10546","10763","10196","2014","2013","Cornell University","sal_ic","Instructional Staff Salary","Assistant professor"
"190415","4","   8","   3","  5","   1","   1","  0","  0"," 0"," 0","0","0","0","  7","  2","  5","   93","   33","  60","   691000","   283000","  408000"," 7430"," 8576"," 6800","2014","2013","Cornell University","sal_ic","Instructional Staff Salary","Instructor"
"190415","5"," 240"," 114","126"," 187","  87","100","  0"," 0"," 0","0","0","0"," 53"," 27"," 26"," 2319"," 1107","1212"," 18604762","  9180531"," 9424231"," 8023"," 8293"," 7776","2014","2013","Cornell University","sal_ic","Instructional Staff Salary","Lecturer"
"190415","7","1720","1154","566","1433"," 960","473","  0"," 0"," 0","0","0","0","287","194"," 93","16341","10968","5373","225837329","160570648","65266681","13820","14640","12147","2014","2013","Cornell University","sal_ic","Instructional Staff Salary","All instructional staff total"
"198419","1"," 643"," 490","153"," 643"," 490","153","  0"," 0"," 0","0","0","0","  0","  0","  0"," 5787"," 4410","1377","113376166"," 89164170","24211996","19592","20219","17583","2014","2013","Duke University","sal_ic","Instructional Staff Salary","Professor"
"198419","2"," 271"," 160","111"," 271"," 160","111","  0"," 0"," 0","0","0","0","  0","  0","  0"," 2439"," 1440"," 999"," 30142374"," 19296277","10846097","12358","13400","10857","2014","2013","Duke University","sal_ic","Instructional Staff Salary","Associate professor"
"198419","3"," 250"," 152"," 98"," 250"," 152"," 98","  0"," 0"," 0","0","0","0","  0","  0","  0"," 2250"," 1368"," 882"," 21094854"," 13571103"," 7523751"," 9375"," 9920"," 8530","2014","2013","Duke University","sal_ic","Instructional Staff Salary","Assistant professor"
"198419","4","  49","  19"," 30","  49","  19"," 30","  0"," 0"," 0","0","0","0","  0","  0","  0","  441","  171"," 270","  2287417","   952995"," 1334422"," 5187"," 5573"," 4942","2014","2013","Duke University","sal_ic","Instructional Staff Salary","Instructor"
"198419","5"," 126","  43"," 83"," 126","  43"," 83","  0"," 0"," 0","0","0","0","  0","  0","  0"," 1134","  387"," 747","  6935641","  2487247"," 4448394"," 6116"," 6427"," 5955","2014","2013","Duke University","sal_ic","Instructional Staff Salary","Lecturer"
"198419","6","  23","  14","  9","  23","  14","  9","  0"," 0"," 0","0","0","0","  0","  0","  0","  207","  126","  81","  1307846","   952269","  355577"," 6318"," 7558"," 4390","2014","2013","Duke University","sal_ic","Instructional Staff Salary","No academic rank"
"198419","7","1362"," 878","484","1362"," 878","484","  0"," 0"," 0","0","0","0","  0","  0","  0","12258"," 7902","4356","175144298","126424061","48720237","14288","15999","11185","2014","2013","Duke University","sal_ic","Instructional Staff Salary","All instructional staff total"
"215062","1"," 581"," 446","135"," 581"," 446","135","  0"," 0"," 0","0","0","0","  0","  0","  0"," 5229"," 4014","1215","111712778"," 87483833","24228945","21364","21795","19942","2014","2013","University of Pennsylvania","sal_ic","Instructional Staff Salary","Professor"
"215062","2"," 234"," 142"," 92"," 234"," 142"," 92","  0"," 0"," 0","0","0","0","  0","  0","  0"," 2106"," 1278"," 828"," 27956515"," 18040209"," 9916306","13275","14116","11976","2014","2013","University of Pennsylvania","sal_ic","Instructional Staff Salary","Associate professor"
"215062","3"," 240"," 144"," 96"," 240"," 144"," 96","  0"," 0"," 0","0","0","0","  0","  0","  0"," 2160"," 1296"," 864"," 28330926"," 17759675","10571251","13116","13703","12235","2014","2013","University of Pennsylvania","sal_ic","Instructional Staff Salary","Assistant professor"
"215062","5"," 278","  91","187"," 278","  91","187","  0"," 0"," 0","0","0","0","  0","  0","  0"," 2502","  819","1683"," 17472331","  6023376","11448955"," 6983"," 7355"," 6803","2014","2013","University of Pennsylvania","sal_ic","Instructional Staff Salary","Lecturer"
"215062","7","1333"," 823","510","1333"," 823","510","  0"," 0"," 0","0","0","0","  0","  0","  0","11997"," 7407","4590","185472550","129307093","56165457","15460","17457","12236","2014","2013","University of Pennsylvania","sal_ic","Instructional Staff Salary","All instructional staff total"
"217156","1"," 372"," 278"," 94"," 307"," 234"," 73"," 61","42","19","0","0","0","  4","  2","  2"," 3421"," 2550"," 871"," 61286451"," 46753234","14533217","17915","18335","16686","2014","2013","Brown University","sal_ic","Instructional Staff Salary","Professor"
"217156","2"," 130","  84"," 46"," 105","  64"," 41"," 24","19"," 5","0","0","0","  1","  1","  0"," 1197","  778"," 419"," 13983421","  9192581"," 4790840","11682","11816","11434","2014","2013","Brown University","sal_ic","Instructional Staff Salary","Associate professor"
"217156","3"," 154","  94"," 60"," 117","  70"," 47"," 34","23","11","0","0","0","  3","  1","  2"," 1429","  872"," 557"," 13696689","  8786719"," 4909970"," 9585","10077"," 8815","2014","2013","Brown University","sal_ic","Instructional Staff Salary","Assistant professor"
"217156","5","  67","  22"," 45","  62","  20"," 42","  5"," 2"," 3","0","0","0","  0","  0","  0","  608","  200"," 408","  5127156","  1636749"," 3490407"," 8433"," 8184"," 8555","2014","2013","Brown University","sal_ic","Instructional Staff Salary","Lecturer"
"217156","6","  58","  27"," 31","  29","  13"," 16","  1"," 0"," 1","2","2","0"," 26"," 12"," 14","  605","  283"," 322","  3054090","  1386275"," 1667815"," 5048"," 4898"," 5180","2014","2013","Brown University","sal_ic","Instructional Staff Salary","No academic rank"
"217156","7"," 781"," 505","276"," 620"," 401","219","125","86","39","2","2","0"," 34"," 16"," 18"," 7260"," 4683","2577"," 97147807"," 67755558","29392249","13381","14468","11406","2014","2013","Brown University","sal_ic","Instructional Staff Salary","All instructional staff total"
"131496","1"," 312"," 213"," 99"," 305"," 211"," 94","  0"," 0"," 0","0","0","0","  7","  2","  5"," 2829"," 1923"," 906"," 56296059"," 39310760","16985299","19900","20442","18748","2015","2014","Georgetown University","sal_ic","Instructional Staff Salary","Professor"
"131496","2"," 248"," 126","122"," 235"," 123","112","  0"," 0"," 0","0","0","0"," 13","  3"," 10"," 2271"," 1143","1128"," 28292816"," 14746175","13546641","12458","12901","12009","2015","2014","Georgetown University","sal_ic","Instructional Staff Salary","Associate professor"
"131496","3"," 130","  57"," 73"," 105","  51"," 54","  0"," 0"," 0","0","0","0"," 25","  6"," 19"," 1245","  531"," 714"," 14076196","  6470643"," 7605553","11306","12186","10652","2015","2014","Georgetown University","sal_ic","Instructional Staff Salary","Assistant professor"
"131496","6"," 269"," 133","136"," 259"," 131","128","  0"," 0"," 0","0","0","0"," 10","  2","  8"," 2451"," 1203","1248"," 22720010"," 12327731","10392279"," 9270","10247"," 8327","2015","2014","Georgetown University","sal_ic","Instructional Staff Salary","No academic rank"
"131496","7"," 959"," 529","430"," 904"," 516","388","  0"," 0"," 0","0","0","0"," 55"," 13"," 42"," 8796"," 4800","3996","121385081"," 72855309","48529772","13800","15178","12145","2015","2014","Georgetown University","sal_ic","Instructional Staff Salary","All instructional staff total"
"147767","1"," 594"," 444","150"," 594"," 444","150","  0"," 0"," 0","0","0","0","  0","  0","  0"," 5346"," 3996","1350","110980471"," 85711033","25269438","20760","21449","18718","2015","2014","Northwestern University","sal_ic","Instructional Staff Salary","Professor"
"147767","2"," 285"," 187"," 98"," 285"," 187"," 98","  0"," 0"," 0","0","0","0","  0","  0","  0"," 2565"," 1683"," 882"," 34271100"," 23168871","11102229","13361","13766","12588","2015","2014","Northwestern University","sal_ic","Instructional Staff Salary","Associate professor"
"147767","3"," 239"," 138","101"," 239"," 138","101","  0"," 0"," 0","0","0","0","  0","  0","  0"," 2151"," 1242"," 909"," 25517250"," 15568947"," 9948303","11863","12535","10944","2015","2014","Northwestern University","sal_ic","Instructional Staff Salary","Assistant professor"
"147767","5"," 285"," 118","167"," 285"," 118","167","  0"," 0"," 0","0","0","0","  0","  0","  0"," 2565"," 1062","1503"," 19195036","  8839656","10355380"," 7483"," 8324"," 6890","2015","2014","Northwestern University","sal_ic","Instructional Staff Salary","Lecturer"
"147767","7","1403"," 887","516","1403"," 887","516","  0"," 0"," 0","0","0","0","  0","  0","  0","12627"," 7983","4644","189963857","133288507","56675350","15044","16697","12204","2015","2014","Northwestern University","sal_ic","Instructional Staff Salary","All instructional staff total"
"162928","1"," 326"," 245"," 81"," 151"," 107"," 44","  8"," 6"," 2","0","0","0","167","132"," 35"," 3443"," 2607"," 836"," 56241694"," 42771976","13469718","16335","16407","16112","2015","2014","Johns Hopkins University","sal_ic","Instructional Staff Salary","Professor"
"162928","2"," 114","  73"," 41","  47","  32"," 15","  0"," 0"," 0","0","0","0"," 67"," 41"," 26"," 1227","  780"," 447"," 13878442","  9046105"," 4832337","11311","11598","10811","2015","2014","Johns Hopkins University","sal_ic","Instructional Staff Salary","Associate professor"
"162928","3"," 206"," 116"," 90","  83","  50"," 33","  0"," 0"," 0","0","0","0","123"," 66"," 57"," 2223"," 1242"," 981"," 20827666"," 12059109"," 8768557"," 9369"," 9709"," 8938","2015","2014","Johns Hopkins University","sal_ic","Instructional Staff Salary","Assistant professor"
"162928","4","  24","   3"," 21","   0","   0","  0","  0"," 0"," 0","0","0","0"," 24","  3"," 21","  288","   36"," 252","  1872559","   256932"," 1615627"," 6502"," 7137"," 6411","2015","2014","Johns Hopkins University","sal_ic","Instructional Staff Salary","Instructor"
"162928","5"," 187","  75","112"," 126","  49"," 77","  1"," 1"," 0","0","0","0"," 60"," 25"," 35"," 1864","  751","1113"," 13123335","  5614864"," 7508471"," 7040"," 7477"," 6746","2015","2014","Johns Hopkins University","sal_ic","Instructional Staff Salary","Lecturer"
"162928","6"," 413"," 228","185"," 132","  79"," 53","  2"," 2"," 0","0","0","0","279","147","132"," 4556"," 2495","2061"," 34247713"," 20276219","13971494"," 7517"," 8127"," 6779","2015","2014","Johns Hopkins University","sal_ic","Instructional Staff Salary","No academic rank"
"162928","7","1270"," 740","530"," 539"," 317","222"," 11"," 9"," 2","0","0","0","720","414","306","13601"," 7911","5690","140191409"," 90025205","50166204","10307","11380"," 8817","2015","2014","Johns Hopkins University","sal_ic","Instructional Staff Salary","All instructional staff total"
"164924","1"," 266"," 186"," 80"," 266"," 186"," 80","  0"," 0"," 0","0","0","0","  0","  0","  0"," 2394"," 1674"," 720"," 45425839"," 32592121","12833718","18975","19470","17825","2015","2014","Boston College","sal_ic","Instructional Staff Salary","Professor"
"164924","2"," 254"," 145","109"," 254"," 145","109","  0"," 0"," 0","0","0","0","  0","  0","  0"," 2286"," 1305"," 981"," 27970415"," 16311984","11658431","12236","12500","11884","2015","2014","Boston College","sal_ic","Instructional Staff Salary","Associate professor"
"164924","3"," 217"," 113","104"," 217"," 113","104","  0"," 0"," 0","0","0","0","  0","  0","  0"," 1953"," 1017"," 936"," 20023421"," 10717414"," 9306007","10253","10538"," 9942","2015","2014","Boston College","sal_ic","Instructional Staff Salary","Assistant professor"
"164924","4","  15","   5"," 10","  15","   5"," 10","  0"," 0"," 0","0","0","0","  0","  0","  0","  135","   45","  90","  1186578","   523250","  663328"," 8789","11628"," 7370","2015","2014","Boston College","sal_ic","Instructional Staff Salary","Instructor"
"164924","5","  34","  21"," 13","  34","  21"," 13","  0"," 0"," 0","0","0","0","  0","  0","  0","  306","  189"," 117","  3195101","  2033902"," 1161199","10442","10761"," 9925","2015","2014","Boston College","sal_ic","Instructional Staff Salary","Lecturer"
"164924","7"," 786"," 470","316"," 786"," 470","316","  0"," 0"," 0","0","0","0","  0","  0","  0"," 7074"," 4230","2844"," 97801354"," 62178671","35622683","13825","14699","12526","2015","2014","Boston College","sal_ic","Instructional Staff Salary","All instructional staff total"
"168148","1"," 255"," 191"," 64"," 198"," 148"," 50","  0"," 0"," 0","0","0","0"," 57"," 43"," 14"," 2466"," 1848"," 618"," 38090153"," 28767923"," 9322230","15446","15567","15085","2015","2014","Tufts University","sal_ic","Instructional Staff Salary","Professor"
"168148","2"," 181","  99"," 82"," 133","  74"," 59","  0"," 0"," 0","0","0","0"," 48"," 25"," 23"," 1773","  966"," 807"," 19849003"," 10941459"," 8907544","11195","11327","11038","2015","2014","Tufts University","sal_ic","Instructional Staff Salary","Associate professor"
"168148","3"," 187","  92"," 95","  87","  51"," 36","  0"," 0"," 0","0","0","0","100"," 41"," 59"," 1983","  951","1032"," 17951504","  8710411"," 9241093"," 9053"," 9159"," 8955","2015","2014","Tufts University","sal_ic","Instructional Staff Salary","Assistant professor"
"168148","4","   8","   3","  5","   1","   0","  1","  0"," 0"," 0","0","0","0","  7","  3","  4","   93","   36","  57","   725311","   295046","  430265"," 7799"," 8196"," 7549","2015","2014","Tufts University","sal_ic","Instructional Staff Salary","Instructor"
"168148","5"," 103","  43"," 60"," 102","  43"," 59","  0"," 0"," 0","0","0","0","  1","  0","  1","  930","  387"," 543","  6669642","  2819396"," 3850246"," 7172"," 7285"," 7091","2015","2014","Tufts University","sal_ic","Instructional Staff Salary","Lecturer"
"168148","7"," 734"," 428","306"," 521"," 316","205","  0"," 0"," 0","0","0","0","213","112","101"," 7245"," 4188","3057"," 83285613"," 51534235","31751378","11496","12305","10386","2015","2014","Tufts University","sal_ic","Instructional Staff Salary","All instructional staff total"
"179867","1"," 357"," 266"," 91"," 340"," 255"," 85","  3"," 1"," 2","0","0","0"," 14"," 10","  4"," 3258"," 2425"," 833"," 63013272"," 47640641","15372631","19341","19646","18455","2015","2014","Washington University in St Louis","sal_ic","Instructional Staff Salary","Professor"
"179867","2"," 179"," 105"," 74"," 177"," 104"," 73","  0"," 0"," 0","0","0","0","  2","  1","  1"," 1617","  948"," 669"," 20241862"," 12213148"," 8028714","12518","12883","12001","2015","2014","Washington University in St Louis","sal_ic","Instructional Staff Salary","Associate professor"
"179867","3"," 178"," 112"," 66"," 177"," 112"," 65","  0"," 0"," 0","0","0","0","  1","  0","  1"," 1605"," 1008"," 597"," 17831390"," 11553745"," 6277645","11110","11462","10515","2015","2014","Washington University in St Louis","sal_ic","Instructional Staff Salary","Assistant professor"
"179867","5"," 160","  72"," 88"," 122","  49"," 73","  6"," 2"," 4","4","1","3"," 28"," 20","  8"," 1538","  712"," 826"," 10338368","  5378433"," 4959935"," 6722"," 7554"," 6005","2015","2014","Washington University in St Louis","sal_ic","Instructional Staff Salary","Lecturer"
"179867","6","  19","   5"," 14","  10","   3","  7","  1"," 0"," 1","0","0","0","  8","  2","  6","  196","   51"," 145","  1359401","   389711","  969690"," 6936"," 7641"," 6688","2015","2014","Washington University in St Louis","sal_ic","Instructional Staff Salary","No academic rank"
"179867","7"," 893"," 560","333"," 826"," 523","303"," 10"," 3"," 7","4","1","3"," 53"," 33"," 20"," 8214"," 5144","3070","112784293"," 77175678","35608615","13731","15003","11599","2015","2014","Washington University in St Louis","sal_ic","Instructional Staff Salary","All instructional staff total"
"182670","1"," 241"," 175"," 66"," 206"," 145"," 61","  1"," 1"," 0","0","0","0"," 34"," 29","  5"," 2272"," 1663"," 609"," 43015632"," 32794072","10221560","18933","19720","16784","2015","2014","Dartmouth College","sal_ic","Instructional Staff Salary","Professor"
"182670","2"," 143","  86"," 57"," 119","  72"," 47","  0"," 0"," 0","0","0","0"," 24"," 14"," 10"," 1359","  816"," 543"," 16283029","  9964529"," 6318500","11982","12211","11636","2015","2014","Dartmouth College","sal_ic","Instructional Staff Salary","Associate professor"
"182670","3"," 118","  72"," 46","  22","  12"," 10","  2"," 0"," 2","0","0","0"," 94"," 60"," 34"," 1346","  828"," 518"," 11904773","  7540737"," 4364036"," 8845"," 9107"," 8425","2015","2014","Dartmouth College","sal_ic","Instructional Staff Salary","Assistant professor"
"182670","4","   4","   2","  2","   1","   1","  0","  3"," 1"," 2","0","0","0","  0","  0","  0","   39","   19","  20","    48000","    24000","   24000"," 1231"," 1263"," 1200","2015","2014","Dartmouth College","sal_ic","Instructional Staff Salary","Instructor"
"182670","5","  46","  18"," 28","   0","   0","  0","  3"," 1"," 2","0","0","0"," 43"," 17"," 26","  546","  214"," 332","  3479660","  1373850"," 2105810"," 6373"," 6420"," 6343","2015","2014","Dartmouth College","sal_ic","Instructional Staff Salary","Lecturer"
"182670","6","   4","   0","  4","   0","   0","  0","  4"," 0"," 4","0","0","0","  0","  0","  0","   40","    0","  40","    33100","        0","   33100","  828",,"  828","2015","2014","Dartmouth College","sal_ic","Instructional Staff Salary","No academic rank"
"182670","7"," 556"," 353","203"," 348"," 230","118"," 13"," 3","10","0","0","0","195","120"," 75"," 5602"," 3540","2062"," 74764194"," 51697188","23067006","13346","14604","11187","2015","2014","Dartmouth College","sal_ic","Instructional Staff Salary","All instructional staff total"
"190150","1"," 757"," 579","178"," 757"," 579","178","  0"," 0"," 0","0","0","0","  0","  0","  0"," 6813"," 5211","1602","152471182","118293789","34177393","22379","22701","21334","2015","2014","Columbia University in the City of New York","sal_ic","Instructional Staff Salary","Professor"
"190150","2"," 230"," 139"," 91"," 230"," 139"," 91","  0"," 0"," 0","0","0","0","  0","  0","  0"," 2070"," 1251"," 819"," 31664105"," 19949016","11715089","15297","15946","14304","2015","2014","Columbia University in the City of New York","sal_ic","Instructional Staff Salary","Associate professor"
"190150","3"," 195"," 134"," 61"," 195"," 134"," 61","  0"," 0"," 0","0","0","0","  0","  0","  0"," 1755"," 1206"," 549"," 22212789"," 14479070"," 7733719","12657","12006","14087","2015","2014","Columbia University in the City of New York","sal_ic","Instructional Staff Salary","Assistant professor"
"190150","4","   3","   0","  3","   3","   0","  3","  0"," 0"," 0","0","0","0","  0","  0","  0","   27","    0","  27","   600000","        0","  600000","22222",,"22222","2015","2014","Columbia University in the City of New York","sal_ic","Instructional Staff Salary","Instructor"
"190150","5"," 375"," 186","189"," 375"," 186","189","  0"," 0"," 0","0","0","0","  0","  0","  0"," 3375"," 1674","1701"," 29359975"," 16678947","12681028"," 8699"," 9964"," 7455","2015","2014","Columbia University in the City of New York","sal_ic","Instructional Staff Salary","Lecturer"
"190150","7","1560","1038","522","1560","1038","522","  0"," 0"," 0","0","0","0","  0","  0","  0","14040"," 9342","4698","236308051","169400822","66907229","16831","18133","14242","2015","2014","Columbia University in the City of New York","sal_ic","Instructional Staff Salary","All instructional staff total"
"190415","1"," 762"," 589","173"," 650"," 499","151","  0"," 0"," 0","0","0","0","112"," 90"," 22"," 7194"," 5571","1623","131840167","103603196","28236971","18326","18597","17398","2015","2014","Cornell University","sal_ic","Instructional Staff Salary","Professor"
"190415","2"," 438"," 277","161"," 363"," 223","140","  0"," 0"," 0","0","0","0"," 75"," 54"," 21"," 4167"," 2655","1512"," 53396123"," 34310945","19085178","12814","12923","12622","2015","2014","Cornell University","sal_ic","Instructional Staff Salary","Associate professor"
"190415","3"," 307"," 185","122"," 272"," 169","103","  0"," 0"," 0","0","0","0"," 35"," 16"," 19"," 2868"," 1713","1155"," 31884663"," 19485100","12399563","11117","11375","10736","2015","2014","Cornell University","sal_ic","Instructional Staff Salary","Assistant professor"
"190415","4","  15","   8","  7","   8","   6","  2","  0"," 0"," 0","0","0","0","  7","  2","  5","  156","   78","  78","  1151680","   610546","  541134"," 7383"," 7828"," 6938","2015","2014","Cornell University","sal_ic","Instructional Staff Salary","Instructor"
"190415","5"," 247"," 112","135"," 189","  87","102","  0"," 0"," 0","0","0","0"," 58"," 25"," 33"," 2397"," 1083","1314"," 20050129","  9440247","10609882"," 8365"," 8717"," 8074","2015","2014","Cornell University","sal_ic","Instructional Staff Salary","Lecturer"
"190415","6","   6","   1","  5","   4","   1","  3","  0"," 0"," 0","0","0","0","  2","  0","  2","   60","    9","  51","   332928","    76000","  256928"," 5549"," 8444"," 5038","2015","2014","Cornell University","sal_ic","Instructional Staff Salary","No academic rank"
"190415","7","1775","1172","603","1486"," 985","501","  0"," 0"," 0","0","0","0","289","187","102","16842","11109","5733","238655690","167526034","71129656","14170","15080","12407","2015","2014","Cornell University","sal_ic","Instructional Staff Salary","All instructional staff total"
"198419","1"," 647"," 491","156"," 647"," 491","156","  0"," 0"," 0","0","0","0","  0","  0","  0"," 5823"," 4419","1404","118334269"," 92753086","25581183","20322","20990","18220","2015","2014","Duke University","sal_ic","Instructional Staff Salary","Professor"
"198419","2"," 273"," 166","107"," 273"," 166","107","  0"," 0"," 0","0","0","0","  0","  0","  0"," 2457"," 1494"," 963"," 31929005"," 20685901","11243104","12995","13846","11675","2015","2014","Duke University","sal_ic","Instructional Staff Salary","Associate professor"
"198419","3"," 250"," 148","102"," 250"," 148","102","  0"," 0"," 0","0","0","0","  0","  0","  0"," 2250"," 1332"," 918"," 22133833"," 14028500"," 8105333"," 9837","10532"," 8829","2015","2014","Duke University","sal_ic","Instructional Staff Salary","Assistant professor"
"198419","4","  74","  30"," 44","  74","  30"," 44","  0"," 0"," 0","0","0","0","  0","  0","  0","  666","  270"," 396","  3845748","  1842687"," 2003061"," 5774"," 6825"," 5058","2015","2014","Duke University","sal_ic","Instructional Staff Salary","Instructor"
"198419","5"," 122","  45"," 77"," 122","  45"," 77","  0"," 0"," 0","0","0","0","  0","  0","  0"," 1098","  405"," 693","  6992264","  2645519"," 4346745"," 6368"," 6532"," 6272","2015","2014","Duke University","sal_ic","Instructional Staff Salary","Lecturer"
"198419","7","1366"," 880","486","1366"," 880","486","  0"," 0"," 0","0","0","0","  0","  0","  0","12294"," 7920","4374","183235119","131955693","51279426","14904","16661","11724","2015","2014","Duke University","sal_ic","Instructional Staff Salary","All instructional staff total"
"215062","1"," 598"," 461","137"," 598"," 461","137","  0"," 0"," 0","0","0","0","  0","  0","  0"," 5382"," 4149","1233","118169582"," 92742731","25426851","21956","22353","20622","2015","2014","University of Pennsylvania","sal_ic","Instructional Staff Salary","Professor"
"215062","2"," 228"," 136"," 92"," 228"," 136"," 92","  0"," 0"," 0","0","0","0","  0","  0","  0"," 2052"," 1224"," 828"," 28551194"," 18308711","10242483","13914","14958","12370","2015","2014","University of Pennsylvania","sal_ic","Instructional Staff Salary","Associate professor"
"215062","3"," 236"," 135","101"," 236"," 135","101","  0"," 0"," 0","0","0","0","  0","  0","  0"," 2124"," 1215"," 909"," 28232460"," 16932123","11300337","13292","13936","12432","2015","2014","University of Pennsylvania","sal_ic","Instructional Staff Salary","Assistant professor"
"215062","5"," 302"," 112","190"," 302"," 112","190","  0"," 0"," 0","0","0","0","  0","  0","  0"," 2718"," 1008","1710"," 19677678","  7775741","11901937"," 7240"," 7714"," 6960","2015","2014","University of Pennsylvania","sal_ic","Instructional Staff Salary","Lecturer"
"215062","7","1364"," 844","520","1364"," 844","520","  0"," 0"," 0","0","0","0","  0","  0","  0","12276"," 7596","4680","194630914","135759306","58871608","15855","17872","12579","2015","2014","University of Pennsylvania","sal_ic","Instructional Staff Salary","All instructional staff total"
"217156","1"," 361"," 270"," 91"," 301"," 228"," 73"," 56","39","17","0","0","0","  4","  3","  1"," 3317"," 2478"," 839"," 60830209"," 46334969","14495240","18339","18699","17277","2015","2014","Brown University","sal_ic","Instructional Staff Salary","Professor"
"217156","2"," 127","  84"," 43"," 101","  63"," 38"," 24","19"," 5","0","0","0","  2","  2","  0"," 1173","  781"," 392"," 14259018","  9596730"," 4662288","12156","12288","11894","2015","2014","Brown University","sal_ic","Instructional Staff Salary","Associate professor"
"217156","3"," 149","  92"," 57"," 117","  72"," 45"," 28","18","10","0","0","0","  4","  2","  2"," 1381","  852"," 529"," 13753124","  8793562"," 4959562"," 9959","10321"," 9375","2015","2014","Brown University","sal_ic","Instructional Staff Salary","Assistant professor"
"217156","5","  72","  24"," 48","  64","  20"," 44","  5"," 2"," 3","0","0","0","  3","  2","  1","  662","  224"," 438","  5698592","  1893887"," 3804705"," 8608"," 8455"," 8687","2015","2014","Brown University","sal_ic","Instructional Staff Salary","Lecturer"
"217156","6","  59","  28"," 31","   7","   3","  4","  6"," 2"," 4","3","1","2"," 43"," 22"," 21","  672","  322"," 350","  4554552","  2213959"," 2340593"," 6778"," 6876"," 6687","2015","2014","Brown University","sal_ic","Instructional Staff Salary","No academic rank"
"217156","7"," 768"," 498","270"," 590"," 386","204","119","80","39","3","1","2"," 56"," 31"," 25"," 7205"," 4657","2548"," 99095495"," 68833107","30262388","13754","14781","11877","2015","2014","Brown University","sal_ic","Instructional Staff Salary","All instructional staff total"
